1111111111111
1001000000NC1
1P00011111001
100E110000001
1111111111111